6
2 5 1 4 3 6
6 1 3 5 5 4
5 3 2 6 6 1 
1 2 4 4 6 5
4 6 1 1 2 3
3 1 6 5 1 2
